  1111111111111111111111111111111111111
  110000000000000000000000000000000011111111111111111111111
 1110000000000000000000000000000000000000000000000000000011
 111000000000000000000000000000000000000000000000000000011
  1111111111111111000000000000000000000000000000000000011
        11111111100000000000000000000000000000000000000011
       111000000000000000000000000000000000000000000000011
      1110000000000000000000000000000000000000000000000011
      1100000000000000000000000000000000000000000000000011
      111000000000000000000000000000000000000000000000011
       1100000000000000000000000000000000000000000000011
      111000000000000000000000000000000000000000000000011
       100000000000000000000000000000000000000000000000011
       100000000000000000000000000000000000000000000000011
      110000000000000000000000000000000000000000000000011
      110000000000000000000000000000000000000000000000111
      11000000000000000000000000000000000000000000001111
      110000000000000000000000000000000000000000011111
      1100000000000000000000000000000000000000011111
      1100000000000000000000000000000000000000111
       1100000000000000000000000000000000000011
       11111111110000W11111111111111111111111
                111111
