C 000,000,250
F 00,200,00

11111111111111111111
10000000000000000001
10000000000100000001
10000000000000000001
10000000000000000001
10000001000000100001
10000010000000000001
10000000000000000001
10000000000000000001
10000000000000000001
100000000N0000000001
10000000000000000001
10000000000000000001
10000000000000000001
10000000000000000001
10000000000000000001
10000000000000000001
10000000000000000001
10000000000000000001
10000000000000000001
10000000000000000001
11111111111111111111
