111111111111111111
100101100001010101
101000001000001001
1000111100N0100011
111111111111111111
