NO ./textures/wall_1.png
SO ./textures/wall_2.png
WE ./textures/wall_3.png
EA ./textures/wood.png

C 000,000,250
F 00,200,00
    
        1111111111111111111111111
        1000000000110000000000001
        1011000001110000000000001
        1001000000000000000000001
111111111011000001110000000000001
100000000011000001110111111111111
11110111111111011100000010001
111110111111111011101010010001111111
110000001101010111000000100011111101
100000000000000011000000100111111111
1000000000000000110101001000111111111111
11000001110101011111011110N0111
11110111 1110101 101111010001
11111111 1111111 111111111111
